NO img/xpm/map4/1.xpm
SO    img/xpm/map4/2.xpm
WE img/xpm/map4/3.xpm
EA    img/xpm/map4/4.xpm
F 50,205,50
C 135,206,235

                      11111
                      1S001
                      10001
                      10001
                      111D1111111
                      100000000011111
                      1000000000D0001
                      1000010000010001
                      1000000000011111
                    111000000000001
                    1000000000000001
                    111111D111111111
                    111111D111111111
                    1000000000000001
                    1000000000000001
      1111111111111100000000000000011111111111111111
      1000000000000100000000000000010000000000000001
      1000000000000100000000000000010000000000000001
      1000000000000D00001000000000010000000000000001
      1000000000000100000000000000010000000000000001
      1000000000000100000000000000010000000000000001
      1000000000000100000000000000011111111111111101
      1111111111111100000000000000000000000000000001
                    111111D1111111111111111111111111
                    11111101
                         101
                         1011111111111111111111111111111111111111111
                         1000000000000000000000000000000000000000001
                         1000000000000000000000000000000000000000001
                         1111111111111111111111111111111111111111111