NO img/xpm/map3/1.xpm
SO    img/xpm/map3/2.xpm
WE img/xpm/map3/3.xpm
EA    img/xpm/map3/4.xpm
F 220,100,0
C 225,30,0

    11111
    1W001
    10001
    1000111
     111
