NO img/xpm/map4/1.xpm
SO    img/xpm/map4/2.xpm
WE img/xpm/map4/3.xpm
EA    img/xpm/map4/4.xpm
F 50,205,50
C 135,206,235

    11111
    10001
    10001
    10001
    111D1111111
    100000000011111
    10N0000000D0001
    1000000000010001
    1000000000011111
  111000000000001
  1000000000000001
   11111111111111
