NO img/xpm/map3/1.xpm
SO    img/xpm/map3/2.xpm
WE img/xpm/map3/3.xpm
EA    img/xpm/map3/4.xpm
F 40,25,10
C 20,10,30

1111111111111111111111111111111111111
1000000000000000000000000000000000001
10N0011111111111101111101111111111111
1000010000000000101000101000000000001
11D111011111D111101010101011111111D11
1000000000000000000010100000000000001
1011111111101111111110111111101111101
1010000000101000000010000000101000101
1010111110101011111011111111101011101
1010000010100000001010000000101000001
1011111010111111101010111111101111111
1000000010000000101010100010100000D01
11111D1111111110101010101110101111101
1000001000000010100000001000101000001
1011111011111010111111101011101111111
10000010100000D0000010001010000000001
1111111111111111111111111111111111111                                            