NO img/xpm/map6/1.xpm
SO    img/xpm/map6/2.xpm
WE img/xpm/map6/3.xpm
EA    img/xpm/map6/4.xpm
F 50,205,50
C 135,206,235

                       1
                      1S1
                      101
                      101
                      101
                      1D1
      11111111111111111011111111111111
      10000000000000001000000000000001
      10111111111111101111111111111101
      10000000000000100000000000000001      1
      11111111111110111111111111111111     101
                  1000000000000000000111111101    1
                  1111111111111111110D00000001   101
                  111111111111111111011111111    101
                  100000000000000000000000001    101
                  100000000011100000000000001    101
                  1000000011111111110000000001   1011111111
                  100000000001110000000000001    10000000001
                  100000000000000000011110001    11111111101
                  100000000111111111111111111            101
                  1D111111111111111111111111             101
                  101                                    101
                  101                                    101
                  101111111111111111111111111111111111111101
                  100000000000000000000000000000000000000001
                  111111111111111111111111111111111111111111