NO img/xpm/map6/1.xpm
SO    img/xpm/map6/2.xpm
WE img/xpm/map6/3.xpm
EA    img/xpm/map6/4.xpm
F 50,205,50
C 135,206,235

11111111111111111111111111111111111111111111111
1N001000100010000000100010000000100010000000101
11101011101110111110101110111110101110111110101
10001000001000100010101000100010001000000010101
10111011111011101010101110101110111111111010101
10000010000010001010000010100010000010000010001
10111110111110111011111110111110111010111111101
10001000100000100000000000100010001010100010001
10111010101111101111111111101110101010111011101
10001010001000000010001000001000101000100010001
10111011101011111010111011101011101110101110101
10000010101000100010100010001010000010101000101
10111010101110101110101110111010111110101011101
10001010101000101010101000100010001000101010001
10111011101110101010101110111110111010101011101
10001000001000101010000010000000100010100010001
10111111101110101011111110111111101110111011101
10000010001000101010001000100010001000100010001
10111011101110101010101110101110111110111011101
10001010001000101010101000101000001000001010001
10111010111011101010101110101011111011111011101
10000010100010001010000010100010001010000010001
10111110101110111011111110111010111010111111101
10001000101000100010001000001010100010100000101
10111010101011101110101111111010101110101111101
10001010001010001000101000000010000000101000001
10111011111010111011101111101111111111101011101
10001010000000100010000010000010001000001010001
10111011111111111011111010111110111011101011101
10001000001000001000001010100000100000100010001
10111011101011101111101010111111101111101011101
10001010101010001000101000100010001000101010001
10111010101010111011101011101011101010101011101
10001010101010100010101010001000001010101000001
10111010101010111010101010111011101110101011101
10000010101010100010001000100010001000100000001
10111110111010111110111110111110111110111111101
10000000100010000010001000100000001000000000101
10111111101110111011101011101111111011111110101
10000000001000100010001010001000000000001000001
10111111101110101110101110111011111111101011111
10000000101000101000101000100010000010101010001
10111111111111111111111111111111111111111111001
10000000000000000000000000000000000000000000001
11111111111111111111111111111111111111111111111                                             