NO img/xpm/map6/1.xpm
SO    img/xpm/map6/2.xpm
WE img/xpm/map6/3.xpm
EA    img/xpm/map6/4.xpm
F 50,205,50
C 135,206,235

11111111111111111111111111111111111111111111111
1N000010001000000010001000100010001000000000001
10111010111011111010111011101010111011111111101
10001000100000001010000000101010001000100000101
10111011101111101011111111101011101110101110101
10000000100010001010000000D00010000010101000101
11101111101110111011101111111011111010101011101
10001000001000100010001000000010001010101010001
10111011111011101110101111111011101010101011101
10001000101010001000101000100010001000101010001
10111010101010111011101011101111101110101011101
10001010101010100010101010001000001000101010001
10111010101010111010101010111011101110101011101
10001000001010100010001000100010001000100000001
10111110111010111110111110111110111110111111101
10000010100010000010001000100000001000000000101
10111010101110111011101011101111111011111110101
10001010101000100010001010001000000000001000001
10111011101110101110101110111011111111101011111
10001000101000101000101000100010000010101010001
10111010101011101011101011101110111010101011101
10001010101010001010001000001000100010000010001
10111010101010111010111011111011101111111011101
10001000001000000010000010000010000010000000001
11111111111111111111111111111111111111111111111                    