NO img/xpm/nave/1.xpm
SO    img/xpm/nave/2.xpm
WE img/xpm/nave/3.xpm
EA    img/xpm/nave/4.xpm
F 130,130,130
C 130,131,131

                      1111111111
                     100000000001
                    100S0000000001
                   1000000000000001
          1111111110000000000000000111111111 
        11000000000000000000000000000000000011
          1000000000000000110000000000000001            
           10000000000000111100000000000001
            100000000000111111000000000001
             1000000000111111110000000001
              1000000011111111110000000111
               100000111111111111000001011
                1000111111111111110001
                 10111111111111111101
                 10000000000000000001
                  100000000000000001
                   1000000000000001
                    10000000000001
                     100000000001
                      1000000001
                       10000001
                        100001
                         1001
                          11